1217,1218,1178,-1,-1,1178,1178,1218,1178,-1,-1,1177,1177,-1,-1,1217,1178,1218,-1,-1,1178,1217,-1,-1,1217,1178,-1,-1,-1,-1,1178,1178,1217,1178,-1,-1,1177,1218,1218,1177,1218,-1,-1,1217,1178,1178,1218,1178,-1,-1
1217,1177,1217,-1,-1,1218,1218,1217,1217,1177,1217,1177,1178,-1,-1,1218,1218,1218,-1,-1,1217,1178,-1,-1,1177,1217,1178,1177,-1,-1,1178,-1,-1,1177,-1,-1,1218,1178,1218,-1,-1,1218,1177,-1,-1,1177,1178,1217,-1,-1
-1,1217,1218,1178,1177,1217,1178,1178,1218,1177,1217,1178,1178,1178,1177,1178,1177,1217,1178,1178,1178,1177,1177,1177,-1,-1,1177,1217,1177,1177,1177,-1,-1,1218,1218,1177,1217,1178,1218,-1,-1,1218,1217,-1,-1,1177,-1,-1,1178,1177
-1,1218,1178,1177,1217,1218,1218,-1,-1,1218,1178,1217,1178,1178,1218,1178,-1,-1,1218,1177,-1,-1,1178,1218,-1,-1,1178,-1,-1,1217,1217,1218,1218,1177,1178,-1,-1,1178,1217,1218,-1,-1,1178,1178,1217,1178,-1,-1,1178,1177
1178,1218,1177,1177,1218,1218,1217,-1,-1,1178,1218,-1,-1,1177,1177,1218,-1,-1,1178,1177,-1,-1,1294,1255,1255,1255,1255,-1,-1,1255,1255,1295,1177,1218,1217,-1,-1,1217,1177,1218,-1,-1,1177,-1,-1,1177,1177,1178,1177,-1
1217,1218,1178,-1,-1,1177,1177,1178,1178,1218,1177,-1,-1,1177,1178,1177,1177,-1,-1,1255,1255,1255,-1,-1,-1,-1,-1,-1,-1,-1,-1,1254,1255,1255,1255,1255,1255,-1,-1,1177,1217,1217,1218,-1,-1,1218,1177,1178,1178,-1
1178,1217,1177,-1,-1,1178,1217,1217,-1,-1,1178,1218,1178,1177,1178,1217,1294,-1,-1,-1,-1,-1,-1,-1,-1,-1,-1,-1,-1,-1,-1,-1,-1,-1,-1,-1,-1,-1,-1,1295,1218,-1,-1,1217,1178,1218,1177,-1,-1,1218
1217,1218,1177,1217,1218,1217,1177,1178,-1,-1,1217,1217,-1,-1,1255,1255,1256,-1,-1,-1,-1,-1,-1,-1,-1,-1,-1,-1,-1,-1,-1,-1,-1,-1,-1,-1,-1,-1,-1,1254,1255,-1,-1,1295,1177,1294,1255,-1,-1,1255
1218,-1,-1,1217,1177,1178,1177,1218,1178,1178,1218,1294,-1,-1,-1,-1,-1,-1,-1,-1,-1,-1,-1,-1,-1,-1,-1,-1,-1,-1,-1,-1,-1,-1,-1,-1,-1,-1,-1,-1,-1,-1,-1,1254,1255,1256,-1,-1,-1,-1
1178,-1,-1,1177,-1,-1,-1,-1,-1,1218,1294,1256,-1,-1,-1,-1,-1,-1,-1,-1,-1,-1,-1,-1,-1,-1,-1,-1,-1,-1,-1,-1,-1,-1,-1,-1,-1,-1,-1,-1,-1,-1,-1,-1,-1,-1,-1,-1,-1,-1
1178,1178,1177,1217,-1,-1,-1,-1,-1,1177,1216,-1,-1,-1,-1,-1,-1,-1,-1,-1,-1,-1,-1,-1,-1,-1,-1,-1,-1,-1,-1,-1,-1,-1,-1,-1,-1,-1,-1,-1,-1,-1,-1,-1,-1,-1,-1,-1,-1,-1
1255,1255,1295,1217,-1,-1,-1,-1,-1,1178,1216,-1,-1,-1,-1,-1,-1,-1,-1,-1,-1,-1,-1,-1,-1,-1,-1,-1,-1,-1,-1,-1,-1,-1,-1,-1,-1,-1,-1,-1,-1,-1,-1,-1,-1,-1,-1,-1,-1,-1
-1,-1,1254,1255,-1,-1,-1,-1,-1,1295,1216,-1,-1,-1,-1,-1,-1,-1,-1,-1,-1,-1,-1,-1,-1,-1,-1,-1,-1,-1,-1,-1,-1,-1,-1,-1,-1,-1,-1,-1,-1,-1,-1,-1,-1,-1,-1,-1,-1,-1
-1,-1,-1,-1,-1,-1,-1,-1,-1,1254,1256,-1,-1,-1,-1,-1,-1,-1,-1,-1,-1,-1,-1,-1,-1,-1,-1,-1,-1,-1,-1,-1,-1,-1,-1,-1,-1,-1,-1,-1,-1,-1,-1,-1,-1,-1,-1,-1,-1,-1
-1,-1,-1,-1,-1,-1,-1,-1,-1,-1,-1,-1,-1,-1,-1,-1,-1,-1,-1,-1,-1,-1,-1,-1,-1,-1,-1,-1,-1,-1,-1,-1,-1,-1,-1,-1,-1,-1,-1,-1,-1,-1,-1,-1,-1,-1,-1,-1,-1,-1
-1,-1,-1,-1,-1,-1,-1,-1,-1,-1,-1,-1,-1,-1,-1,-1,-1,-1,-1,-1,-1,-1,-1,-1,-1,-1,-1,-1,-1,-1,-1,-1,-1,-1,-1,-1,-1,-1,-1,-1,-1,-1,-1,-1,-1,-1,-1,-1,-1,-1
-1,-1,-1,-1,-1,-1,-1,-1,-1,-1,1175,1176,-1,-1,-1,-1,-1,-1,-1,-1,-1,-1,-1,-1,-1,-1,-1,-1,-1,-1,-1,-1,-1,-1,-1,-1,-1,-1,-1,-1,-1,-1,-1,-1,-1,-1,-1,-1,-1,-1
1176,-1,-1,-1,1175,1175,1175,1175,1175,1335,-1,-1,-1,-1,-1,-1,-1,-1,-1,-1,-1,-1,-1,-1,-1,-1,-1,-1,-1,-1,-1,-1,-1,-1,-1,-1,-1,-1,-1,-1,-1,-1,-1,-1,-1,-1,-1,-1,-1,-1
1334,1175,1175,1335,1178,-1,-1,1217,1177,1177,-1,-1,-1,-1,-1,-1,-1,-1,-1,-1,-1,-1,-1,-1,-1,-1,-1,-1,-1,-1,-1,-1,-1,-1,-1,-1,-1,-1,-1,-1,-1,-1,-1,-1,-1,-1,-1,-1,-1,-1
-1,-1,1177,1218,1217,-1,-1,1217,1217,1218,1218,1334,1176,-1,-1,-1,-1,-1,-1,-1,-1,-1,-1,-1,-1,-1,-1,-1,-1,-1,-1,-1,-1,-1,-1,-1,-1,-1,-1,-1,-1,-1,-1,-1,-1,-1,-1,-1,-1,-1
-1,-1,1177,1217,1217,1218,1177,1217,-1,-1,1178,1177,1334,1176,-1,-1,-1,-1,-1,-1,-1,-1,-1,-1,-1,-1,-1,-1,-1,-1,-1,-1,-1,-1,-1,-1,-1,-1,-1,-1,-1,-1,-1,-1,-1,-1,-1,-1,-1,-1
1217,1178,1217,1177,-1,-1,1217,1218,-1,-1,1217,1178,1178,1334,1175,1176,-1,-1,-1,-1,-1,-1,-1,-1,-1,-1,-1,-1,-1,-1,-1,-1,-1,-1,-1,-1,-1,-1,-1,-1,-1,-1,-1,-1,-1,-1,-1,-1,-1,-1
1217,1217,1177,1177,-1,-1,1177,1178,1178,1218,1178,1178,1177,-1,-1,1334,1175,1175,1176,-1,-1,-1,-1,-1,-1,-1,-1,-1,-1,-1,-1,-1,-1,-1,-1,-1,-1,-1,-1,-1,-1,-1,-1,-1,-1,-1,-1,-1,-1,-1
1217,1218,-1,-1,1178,1218,1177,1177,1177,1178,1177,1177,1177,-1,-1,1218,1217,1218,-1,-1,1175,1176,-1,-1,-1,-1,-1,-1,-1,-1,-1,-1,-1,-1,-1,-1,-1,1174,-1,-1,1176,-1,-1,-1,-1,-1,-1,-1,-1,-1
1218,1218,-1,-1,1178,1178,1218,1177,-1,-1,1178,1178,1178,1218,1218,1218,1177,1177,-1,-1,1178,1334,1176,-1,-1,-1,-1,-1,-1,-1,-1,-1,-1,-1,1174,-1,-1,1335,1178,1217,1334,-1,-1,1176,-1,-1,-1,-1,-1,-1
-1,1217,1217,1217,1217,1177,1218,1217,-1,-1,1177,-1,-1,1177,1178,-1,-1,1217,1217,1177,1177,1218,1334,1175,-1,-1,1175,1175,-1,-1,1175,1175,1175,-1,-1,1217,1218,1218,1218,-1,-1,1217,1177,-1,-1,-1,-1,1175,-1,-1
-1,1217,1177,1218,-1,-1,1177,1178,1178,1178,1217,-1,-1,1217,1218,-1,-1,1178,1178,-1,-1,1177,1177,1178,-1,-1,1217,1217,-1,-1,-1,-1,1217,-1,-1,1178,1217,-1,-1,-1,-1,1177,1217,-1,-1,1217,-1,-1,1217,1177
1178,1177,1178,1177,-1,-1,1217,1177,1177,-1,-1,1178,1177,1178,1217,1218,1177,1218,1217,-1,-1,1217,1217,1217,1217,1218,1217,-1,-1,1218,-1,-1,1177,1218,1177,1177,1218,-1,-1,1218,1178,1178,1178,-1,-1,1178,-1,-1,1218,-1
